PLAYER=8 10
CENTER=8 10

MAP=
00000000000000000000
00000000000000000000
00000000111000000000
00000001121100000000
00000001222111111000
00111111222222221000
00132222222222221100
00133222222444222111
00153222222242422221
00133222222222222221
00132222222222222221
00111111222224222421
00000001222222222221
00000001111111111111
00000000000000000000
